ZZZZZZZZZZZZZZZZZZZZZZZZZZZZZZZZZZZZZZZZZZZZZZZZZZZZZZZZZZZZZZZ
ZZZZZZ                                                    ZZZZZ
ZZZZZZ                                                    ZZZZZ
ZZZZZZ                                                    ZZZZZ
ZZZZZZ                                                    ZZZZZ
ZZZZZZ                                                    ZZZZZ
ZZZZZZ                                                    ZZZZZ
ZZZZZZ                                                    ZZZZZ
ZZZZZZ                                                    ZZZZZ
ZZZZZZ                                                    ZZZZZ
ZZZZZU      P        M   M   M   M     M   M   M    M   M ZZZZZ
ZZZZZZZZZZZZZZZZZZZZZZZZZZZZZZZZZZZZZZZZZZZZZZZZZZZZZZZZZZZZZZZ