.                                                              Z Z Z Z
.                                                              ZZZZZZZ
.                                                               ZOOOOZ
.                                                               ZZZZZZ
.                                                               ZOOOOZ
.                                                               ZZZZZZ
.                                                               ZOOOOZ
Z                                                               ZZZZZZ
Z                                                               ZOOOOZ
Z                                                               ZZZZZZ
Z  P      M     M    H   H  M  h   H     M  H     M       M     UZZZZZ
XXXXXXXXXXXXXXXXXXXXXXXXXXXXXXXXXXXXXXXXXXXXXXXXXXXXXXXXXXXXXXXXXXXXXX