.                                                                          Z Z Z Z
.                                                                          ZZZZZZZ
.                                                                           ZOOOOZ
.                                                                           ZZZZZZ
Z Z Z Z                                                                     ZOOOOZ
ZZZZZZZ                                                                     ZZZZZZ
ZZZZZZZ                                                                     ZOOOOZ
ZOZOZZ                                                                      ZZZZZZ
ZZZZZZ                                                                      ZOOOOZ
ZOZOZZ                                                                      ZZZZZZ
ZZZZZZ   P      M     M    H   H  M  h   H     M  H     M       M           UZZZZZ
XXXXXXXXXXXXXXXXXXXXXXXXXXXXXXXXXXXXXXXXXXXXXXXXXXXXXXXXXXXXXXXXXXXXXXXXXXXXXXXXXX